The at least one	所述至少一个
schematic diagram	示意图
based on	根据
The method	该方法
access to	访问
pick up	搭载
that is	即
may include	可以包括
accessible to	可访问
computing system	计算系统
terminal	终端
:	：
application	应用
generally	一般
store	储存
example	示例
user	用户
have	拥有
customer	顾客
vehicle	车辆
object	待扫描对象
comprising	包括
and/or	和/或
information	信息
having	包括
wherein	其中
illustrates	示出了
camera	相机
)	）
Further	此外
first	第一
identity	身份
may	可以
server	服务器
section	单元
operation	操作
